...	…	!
32 bit	32 bites (rendszer)	!
64 bit	64 bites (rendszer)	!
AND	ÉS	!
ASCII	ASCII	!
Abstract	Elvont, elvonatkoztatott, kivonat, kivonatolt, absztrakt	!
Accept	Elfogadás	!
Active	Aktív	!
Address	Cím	!
Address book	címjegyzék	!
Addressbook	címjegyzék	!
Administration	Adminisztráció	!
Aggregate	Összetett	!
Alarm	Figyelmeztetés	!
Align	Igazítás	!
Alpha	Alfa	!
Analog	Analóg	!
Analysis	Analízis	!
Anchor	Horgony	!
Animation	Animáció	!
Anonymous	Névtelen	!
Answer mode	Válaszadási mód	!
Antialiasing	Élsimítás	!
Append	Hozzáfűzés	!
Applet	Kisalkalmazás	!
Application	Alkalmazás	!
Application Launcher	Alkalmazásindító	!
Arc	Ív	!
Argument	Paraméter, argumentum	!
Array	Tömb (memóriaszerkezet), Fürt (alkatrészek rendszere)	!
Arrow key	Nyílbillentyű	!
Article	Cikk	!
Ascending order	Növekvő sorrend	!
Asynchronous	Aszinkron	!
Attribute	Attribútum, jellemző	!
Audio	Hang	!
Authentication	Hitelesítés	!
Author	Szerző	!
Autofill	Automatikus kitöltés	!
Availability	Elérhetőség	!
Average	Átlag	!
Axis	Tengely	!
Background	Háttér	!
Balance	Egyensúly	!
Base	Alap	!
Binary	Bináris	!
Binding	Kötés	!
Bit	Bit	!
Bitmap	Bitkép	!
Blank	Üres	!
Blinking cursor	Villogó kurzor	!
Blocked	Blokkolt	!
Blur image	Kép elmosása	!
Bold	Félkövér	!
Boolean	Logikai	!
Box	Doboz	!
Branch	Ág	!
Bricks	Téglák	!
Browse	Böngészés	!
Browser	Böngésző	!
Buffer	Puffer	!
Build	Fordítás	!
Bullet	Felsorolásjel	!
Bulletin Board	Hirdetőtábla	!
Bus	Busz	!
Busy	Foglalt	!
Button	Gomb	!
C	C	!
CD	CD	!
CORBA	CORBA	!
CPU	CPU	!
Cache	Gyorsítótár	!
Calculator	Számológép	!
Calendar	Naptár	!
Call	Hívás	!
Caption	Felirat	!
Case Sensitive	Kis- és nagybetű	!
Categories	Kategóriák	!
Cell	Cella	!
Cellular	Mobil	!
Center	Középre	!
Channel	Csatorna	!
Character set	Karakterkészlet	!
Chat	Csevegés	!
Check bit	Ellenőrző bit	!
Class	Osztály	!
Classification	Besorolás	!
Clear	Törlés	!
Click	Kattintás	!
Clipboard	Vágólap	!
Close	Bezárás	!
Coefficient	Együttható	!
Collaboration	Együttműködés	!
Collate	Szétválogatás	!
Collision	Ütközés	!
Command	Parancs	!
Command Line	Parancssor	!
Command line options	Parancssori kapcsolók	!
Common properties	Általános tulajdonságok	!
Compare	Összehasonlítás	!
Concatenate	Összefűzés	!
Condition	Feltétel	!
Conduit	Csatoló	!
Confidential	Bizalmas	!
Configuration	Beállítás	!
Confirm	Megerősíteni	!
Confirmation	Megerősítés	!
Connection	Kapcsolat	!
Constraint	Megszorítás	!
Content	Tartalom	!
Continue	Folytatás	!
Control	Vezérlés	!
Conversion	Átalakítás	!
Copy	Másolás	!
Copyright	Copyright	!
Core file	Core fájl	!
Correlation	Korreláció	!
Cost	Költség	!
Count	Mennyiség	!
Covariance	Kovariancia	!
Create	Létrehozás	!
Critical error	Kritikus hiba	!
Cross Site Scripting	webhelyközi parancsfájl	!
Cross-reference	Kereszthivatkozás	!
Ctrl	Ctrl	!
Current	Jelenlegi	!
Cursor	Kurzor, Sormutató	!
Curve	Görbe	!
Customize	Testreszabás	!
Cut	Kivágás	!
DMA	DMA	!
DNS	DNS	!
Daemon	Démon	!
Data	Adat	!
Debug	Hibakeresés	!
Decrease	Csökkentés	!
Default	Alapértelmezett	!
Delete	Törlés	!
Dependence	Függőség	!
Derived	Származtatott	!
Descending sort	Csökkenő sorrend	!
Descriptor	Leíró	!
Desktop Publishing	kiadványszerkesztés	!
Destination	Cél	!
Destroy	Kilövés	!
Detection	Felismerés	!
Device	Eszköz	!
Diagonal	Átló	!
Diagram	Diagram	!
Dial	Tárcsázás	!
Dialog Box	Párbeszédablak doboz	!
Dialout Device	Kitárcsázó eszköz	!
Digits	Számjegyek	!
Dimension	Dimenzió	!
Direction	Irány	!
Directory	Könyvtár	!
Disable	Tiltás	!
Discard	Eldobás	!
Disconnect	leválasztás	!
Discrete	Diszkrét	!
Dismiss	Eltüntetés	!
Dissipation	Veszteség	!
Distribute	Elosztás	!
Dithering	Színszórás, Árnyalás	!
Division by zero	Osztás nullával	!
Document	Dokumentum	!
Domain	Tartomány	!
Dot	Pont	!
Download	Letöltés	!
Drawing Area	Rajzterület	!
Drop	Ejtés	!
Drop down menu	Legördülő menü	!
Druid	Varázsló	!
Duplicate...	Kétszerezés	!
Dynamic	Dinamikus	!
E-mail	E-mail	!
Echo	Visszhang	!
Edge	Szél	!
Edit	Szerkesztés	!
Effects	Hatások	!
Eject	Kiadás	!
Electronic Mail	Elektronikus levél	!
Enable	Engedélyezés	!
Encapsulated PostScript	Encapsulated PostScript	!
Encoding	Kódolás	!
Engineering	Műszaki tervezés	!
Entity	Entitás	!
Equation	Egyenlet	!
Error	Hiba	!
Ethernet	Ethernet	!
Event	Esemény	!
Exception	Kivétel	!
Exclusive OR	Kizáró VAGY	!
Execute	Végrehajtás	!
Exit	Kilépés	!
Expanded memory	Kiterjesztett memória	!
Exponential notation	Exponenciális ábrázolás	!
Export	Exportálás	!
Extension	Kiterjesztés	!
FTP	FTP	!
Favorite	Kedvenc	!
Fax	Fax	!
File	Fájl	!
Filename	Fájlnév	!
Filesystem	Fájlrendszer	!
Fill	Kitöltés	!
Find	Keresés	!
Firmware	Firmware	!
Fixed Font	Rögzített szélességű betűkészlet	!
Float	Lebegő	!
Floppy	Floppy	!
Flowchart	Folyamatábra	!
Folder	Mappa	!
Font	Betűkészlet	!
Footer	Élőláb	!
Forecast	Előrejelzés	!
Foreground	Előtér	!
Form	Űrlap	!
Formula	Képlet	!
Fraction	Tört	!
Frame	Keret	!
Free Software	Szabad szoftver	!
Frequency	Frekvencia	!
GNOME	GNOME	!
GNU	GNU	!
GPL	GPL	!
GTK+	GTK+	!
GUI	felület, grafikus felület	!
Gamma	Gamma	!
Geometry	Geometria	!
Global	Globális	!
Grab	Elkapás	!
Gradient	Színátmenet	!
Graph	Grafikon	!
Graphical user interface	Grafikus felhasználói felület	!
Grid	Rács	!
Group	Csoport	!
Gutter	Kötésmargó	!
HTML	HTML	!
HTTP	HTTP	!
Hacker	Hacker	!
Handshake	Kézfogás	!
Hard Disk	Merevlemez	!
Header	Élőfej, Fejléc	!
Hello World	Szia Világ	!
Help	Súgó	!
Hex	Hexa	!
Hidden file	Rejtett fájl	!
Hide	Elrejtés	!
Highlight...	Kiemelés...	!
Histogram	Hisztogram	!
History	Előzmények	!
Home	Kezdőlap	!
Home Page	Honlap	!
Home directory	Saját könyvtár	!
Homogeneous environment	Homogén környezet	!
Host	Gép	!
Host name	Gépnév	!
Hot Key	Gyorsbillentyű	!
Hotkey	Gyorsbillentyű	!
Hue	Árnyalat	!
I/O subsystem	I/O alrendszer	!
ID	Azonosító	!
IDE	IDE	!
IP address	IP-cím	!
IRC	IRC	!
Icon	Ikon	!
Identifier	Azonosító	!
Idle	Üresjárat	!
Illegal	Szabálytalan	!
Image	Kép, lemezkép	!
Implementation	Implementáció	!
Import	Importálás	!
Inactive window	Inaktív ablak	!
Increase	Növelés	!
Indent	Behúzás	!
Index	Tárgymutató, Index (adatbázisnál)	!
Indicator	Jelző	!
Inode	Inode	!
Input	Bemenet	!
Input/output	Bemenet/kimenet	!
Insertion point	Beszúrási pont	!
Install	Telepítés	!
Intercept	Metszéspont	!
Interface	Felület (szoftver), Csatoló (hardver)	!
Internal bug	Belső hiba	!
Internal error	Belső hiba	!
International	Nemzetközi	!
Interrupt	Megszakítás	!
Intersect	Metszet	!
Intuitive	Intuitív	!
Invalid	Érvénytelen	!
Invert Selection	Kijelölés megfordítása	!
Invisible	Láthatatlan	!
JPEG	JPEG	!
Jaz Drive	Jaz-meghajtó	!
Job	Feladat	!
Justify	Sorkizárt	!
KDE	KDE	!
Kernel	Rendszermag	!
Key	Billentyű, Kulcs (GConf)	!
Keyboard	Billentyűzet	!
Keyboard shortcut	Gyorsbillentyűk	!
Keyword	Kulcsszó	!
Kill	Kilövés	!
Kill app	Alkalmazás kilövése	!
Kilobyte	Kilobájt	!
LaTeX	LaTeX	!
Label	Címke	!
Lambda	Lambda	!
Landscape	Fekvő	!
Language	Nyelv	!
Launcher	Indítóikon	!
Layer	Réteg	!
Legal	Legal	!
Length	Hossz	!
Letter	Letter	!
License agreement	Licencegyezmény	!
Limits	Korlátok	!
Linux	Linux	!
Local	Helyi	!
Location	Hely	!
Lock	Zárolás	!
Log	Napló	!
Logical	Logikai	!
Login	Bejelentkezés	!
Logout	Kijelentkezés	!
Look	Kinézet	!
Lookup	Keresés	!
Loop	Hurok, hurokeszköz, Ciklus	!
MDI	MDI	!
MIME Type	MIME-típus	!
MINIX	MINIX	!
MS	MS	!
MSDOS	MS-DOS	!
MTU	MTU	!
Macro	Makró	!
Mail	Levél	!
Mail Client	Levelezőkliens	!
Mail server	Levelezőkiszolgáló	!
Mailbox	Postafiók	!
Main body	Fő törzs	!
Man Pages	Man oldalak	!
Manager	Kezelő	!
Manual	Kézikönyv	!
Manual page	Kézikönyvoldal	!
Margins	Margók	!
Mark	Jel	!
Median	Medián	!
Meeting	Találkozó	!
Memory	Memória	!
Menu	Menü	!
Merge	Összefűzés	!
Message	Üzenet	!
Metadata	Metaadat	!
Metafile	Metafájl	!
Minimize	Minimalizálás	!
Mode	Mód	!
Model	Modell	!
Modem	Modem	!
Modifier	Módosítóbillentyű	!
Modify	Módosítás	!
Module	Modul	!
Monitor	Monitor	!
Mount	csatolás	!
Mouse Cursor	Egérkurzor	!
Move	Áthelyezés	!
NO-DAEMON	NO-DAEMON	!
Nautilus	Nautilus	!
Netmask	Hálózati maszk	!
Netscape	Netscape	!
Network	Hálózat	!
Note that	Ne feledje, hogy	!
Notebook	noteszgép	!
Notification	Értesítés	!
Number	Szám	!
Numbered List	Számozott lista	!
Numeric	Numerikus	!
OR	VAGY	!
Object code	Tárgykód	!
Observations	Megfigyelések	!
Obsolete	Elavult	!
Offline	Offline	!
On Screen Display	OSD, képernyőkijelzés (OSD)	!
Online	Online	!
Opacity	Átlátszatlanság	!
Open	Megnyitás	!
Open Source	Nyílt forrású	!
Operating System	Operációs rendszer	!
Operation	Művelet	!
Orientation	Tájolás	!
Origin	Eredet	!
Output	Kimenet	!
Overwrite	Felülírás	!
Owner	Tulajdonos	!
PID	PID	!
PPP	PPP	!
Pack	Csomag	!
Package	Csomag	!
Packet	Csomag	!
Padding	Kitöltés	!
Page	Oldal	!
Pager	Személyhívó	!
Palette	Paletta	!
Panel	Panel	!
Parameter	Paraméter	!
Parcel	Csomag	!
Parse	Feldolgozni	!
Password	Jelszó	!
Paste	Beillesztés	!
Path	Útvonal	!
Pattern	Minta	!
Period	Időtartam	!
Periodic	Periodikus	!
Perl	Perl	!
Perl Script	Perl-parancsfájl	!
Permission	Jogosultság	!
Picker Settings	Pipetta beállításai	!
Pilot device	Pilot eszköz	!
Pipe	Adatcsatorna, átirányítani	!
Pixel	Képpont	!
Pixmap	Kép	!
Place	Hely	!
Play	Lejátszás	!
Plug-in	Bővítmény	!
Point	Pont	!
Policy	Szabály	!
Polygon	Sokszög	!
Polyline	Töröttvonal	!
Portrait	Álló	!
PostScript	PostScript	!
Postal Box	Postafiók	!
Preferences	Beállítások	!
Prefix	Előtag	!
Preview	Előnézet	!
Primary Colors	Elsődleges színek	!
Print	Nyomtatás	!
Print area	Nyomtatási terület	!
Printer	Nyomtató	!
Priority	Prioritás	!
Privacy	Adatvédelem	!
Private Messages	Személyes üzenetek	!
Private key	Személyes kulcs	!
Problem	Probléma	!
Process	Folyamat	!
Process ID	Folyamatazonosító	!
Processor	Processzor	!
Progress	Folyamat	!
Progress Bar	Folyamatjelző	!
Properties	Tulajdonságok	!
Proportional font	Proporcionális betűkészlet	!
Protected	Védett	!
Protection	Védelem	!
Protocol	Protokoll	!
Proxy	Proxy	!
Public	Nyilvános	!
Public Key	Nyilvános kulcs	!
Query	Lekérdezés	!
Queue	Várólista	!
Quit	Kilépés	!
RPM package	RPM-csomag	!
Radio	Rádió	!
Radio Button	Választógomb	!
Random	Véletlen	!
Range	Tartomány	!
Rank	Sorrend	!
Rating	Értékelés	!
Ratio	Arány	!
Raw data	Nyers adat	!
Raw memory	Nyers memória	!
Real Memory	Valós memória	!
Real time	Valós idejű	!
Reboot	Újraindítás	!
Receive	Fogadás	!
Receptivity	Érzékenység	!
Rectangle	Téglalap	!
Recurrence	Ismétlődés	!
Recursion	Rekurzió	!
Redisplay	Újrarajzolás	!
Redo	Újra	!
Refresh	Frissítés	!
Region	Régió	!
Regular expression	Reguláris kifejezés	!
Regulate	Szabályozás	!
Relationship	Kapcsolat	!
Release	Kiadás	!
Remote	Távoli	!
Remove	Eltávolítás	!
Rename	Átnevezés	!
Repeat	Ismétlés	!
Repetitive Strain Injury (RSI)	ismétlődő mozgásból eredő izomhúzódás	!
Replace	Csere	!
Reports	Jelentések	!
Reset	Visszaállítás	!
Resident	Rezidens	!
Resident memory	Rezidens memória	!
Resize	Átméretezés	!
Resolution	Felbontás	!
Restart	Újraindítás	!
Resume	Folytatás	!
Retry	Újra	!
Revert	Visszaállítás	!
Root Directory	Gyökérkönyvtár	!
Rotate	Forgatás	!
Row	Sor	!
Run	Futtatás	!
SCSI	SCSI	!
SLIP	SLIP	!
SMTP	SMTP	!
SOCKS Server	SOCKS-kiszolgáló	!
SYLK file	SYLK-fájl	!
Sample	Minta	!
Saturation	Telítettség	!
Save	Mentés	!
Save As	Mentés másként	!
Scalable	Skálázható	!
Scalar	Skaláris	!
Scale	Méretezés	!
Screensaver	Képernyővédő	!
Screenshot	Képernyőkép	!
Script	Parancsfájl	!
Scroll	Görgetés	!
Scrollbars	Görgetősávok	!
Search	Keresés	!
Search Domains	Keresési tartomány	!
Secondary Colors	Másodlagos színek	!
Secure channel	Biztonságos csatorna	!
Security	Biztonság	!
Segmentation Fault	Szegmentációs hiba	!
Selection	Kijelölés	!
Send	Küldés	!
Sensitive	Érzékeny	!
Separator	Elválasztó	!
Server	Kiszolgáló	!
Set	Beállítás	!
Settings	Beállítások	!
Setup	Beállítás	!
Severity	Súlyosság	!
Share	Megosztás	!
Shared Memory	Osztott memória	!
Shift key	Shift billentyű	!
Show	Megjelenítés	!
Shut Down	Leállítás	!
Signal	Szignál	!
Skip	Kihagyás	!
Smart	Okos	!
Smart terminal	Okos terminál	!
Socket	Foglalat	!
Software Foundation	Szoftver Alapítvány	!
Sort	Rendezés	!
Source	Forrás	!
Source code	Forráskód	!
Space character	Szóköz karakter	!
Spam	Levélszemét	!
Special character	Speciális karakter	!
Spell Checker	Helyesírás-ellenőrző	!
Stack	Verem	!
Standard	Szabványos	!
Standby	Készenlét	!
Start	Indítás	!
Startup	Indulás	!
State	Állapot	!
Statistics	Statisztika	!
Status	Állapot	!
Stereotype	Előítélet	!
Stock Ticker	Részvényfigyelő	!
Storage	Tároló	!
Strikethrough	Áthúzott	!
String	Karakterlánc	!
Style	Stílus	!
Subdirectory	Alkönyvtár	!
Subject	Tárgy	!
Submenu	Almenü	!
Submit	Elküldés	!
Subnet	Alhálózat	!
Subscript	Alsó index	!
Suffix	Utótag	!
Superscript	Felső index	!
Support	Támogatás	!
Suspend	Felfüggesztés	!
Swap	Lapozás (swap)	!
Symbol	Szimbólum	!
Symbolic link	Szimbolikus link	!
Synchronize	Szinkronizálás	!
Syndication	Tartalommegosztás (RSS)	!
Syntax error	Szintaktikai hiba	!
System	Rendszer	!
System Configuration	Rendszerbeállítás	!
TCLASS	TCLASS	!
TCP/IP	TCP/IP	!
TERM variable	TERM-változó	!
Talk	Csevegés	!
Telnet	Telnet	!
Template	Sablon	!
Terminal	Terminál	!
Terminate	Megszakítás	!
Test	Teszt	!
Test Module	Teszt-modul	!
Text	Szöveg	!
Text only	Csak szöveg	!
Theme	Téma	!
Threshold	Küszöb	!
Thumb Nails	Bélyegkép, Előnézet (pl. betűtípus)	!
Tile	Csempe	!
Time format	Időformátum	!
Timezone	Időzóna	!
Title	Cím	!
Tolerance	Tűréshatár	!
Tool	Eszköz	!
Toolbar	Eszköztár	!
Tooltip	Buboréksúgó	!
Transfer	Átvitel	!
Translate	Fordítás	!
Transparent	Átlátszó	!
Trash	Kuka	!
Tree	Fa	!
Trim	Levágás	!
Tty	Tty	!
Turing Machine	Turing gép	!
Type	Típus	!
Type mismatch	Nem megfelelő típus	!
UNIX	UNIX	!
URI	Egységes erőforrás-azonosító, URI cím	!
URL	URL, Egységes erőforrás-hivatkozás, URL-cím	!
USB	USB	!
Undelete	Törlés visszavonása	!
Underline	Aláhúzott	!
Undo	Visszavonás	!
Unicode	Unicode	!
Uninstall	Eltávolítás	!
Unknown host	Ismeretlen kiszolgáló	!
Unload	Eltávolítás	!
Untitled	Névtelen	!
Update	Frissítés	!
Upgrade	Frissítés	!
Uptime	Működési idő	!
User	Felhasználó	!
User Interface	Felhasználói felület	!
User defined	Felhasználó által megadott, Egyéni	!
Username	Felhasználónév	!
VERBOSE	VERBOSE	!
VFS	VFS	!
Valid chars	Érvényes karakterek	!
Value	Érték	!
Variable	Változó	!
Vector Graphics	Vektorgrafika	!
Vendor	Gyártó	!
Verify	Ellenőrzés	!
Version	Verzió	!
Vertical	Függőleges	!
Vertical Alignment	Függőleges igazítás	!
Video	Video	!
View	Nézet	!
Viewport	Munkalap	!
Virtual	Virtuális	!
Visualization	Képi megjelenítés	!
WVLAN	WVLAN	!
Wallpaper	Háttérkép	!
Warning	Figyelmeztetés	!
Watch file	Fájl figyelése	!
Web Page	Weboldal	!
Weight	Vastagság	!
Widget	Elem, Felületi elem	!
Width	Szélesség	!
Window	Ablak	!
Window Manager	Ablakkezelő	!
Word	Szó	!
Work	Munka	!
Work With	... kezelése	!
Workbook	Munkafüzet	!
Wrap	Tördelés	!
Write	Írás	!
X Align	X-igazítás	!
X server	X-kiszolgáló	!
XDMCP socket	XDMCP foglalat	!
XML	XML	!
Zigzagline	Cikcakk vonal	!
Zip Drive	Zip-meghajtó	!
Zoom	Nagyítás	!
\"	„”	!
\'	„”	!
abbreviated	rövidített	!
abort	megszakítás	!
about	Névjegy	!
absence, of sg	(vmi) hiánya	!
absent	hiányzó	!
absolute record	abszolút hivatkozás	!
absolute value	abszolút érték	!
ac	hálózati tápellátás	!
acceleration	gyorsítás	!
accelerator	hívóbetű (_UI-n)	?
accent	ékezet	!
accept changes	változások elfogadása	!
accept or discard	elfogadás vagy elutasítás	!
accepted	elfogadva	!
access	hozzáférés	!
access  control list	hozzáférés-vezérlési lista	!
access denied	hozzáférés megtagadva	!
access key	hívóbetű (_UI, MS-izmus)	!
access point	hozzáférési pont	!
accessibility	akadálymentesítés	!
accessories	kellékek, kiegészítők	!
accessory	kiegészítő	!
account	felhasználói fiók, fiók	!
account name	fiók neve	!
accuracy	pontosság	!
acronym	betűszó	!
action	művelet	!
activate	bekapcsolás	!
actual	tényleges (NEM: aktuális)	!
ad-hoc	eseti	!
add	hozzáadás	!
add-in	kiegészítő	!
addition +	Összeadás +	!
additional parameter	további paraméter	!
addon	bővítmény	!
address field	címmező	!
address space	címtér (IP)	!
addressbook	címjegyzékAttempt Attempt 	!
addressee	címzett	!
adhoc	eseti	!
adjust	módosítás, igazítás	?
administration	Adminisztráció	?Felügyelet
administrator	rendszergazda	!
advance slides	dia továbbítása	!
advanced	fejlett, speciális (extra beállítások elérése), tapasztalt (felhasználó), NEM: haladó 	!
advantage	előny	!
affiliation	kapcsolat	!
agenda	napirend	!
agents	Ügynökök	!
aging	elévülés	!
airbrush	festékszóró	!
album art	albumgrafika	!
alert	riasztás, értesítés, figyelmeztetés 	?
alias	álnév	!
alignment	igazítás	!
allocate	lefoglalni	!
allow	engedélyez, lehetővé tesz	!
allow moving	mozgatás engedélyezése	!
alpha channel	alfa csatorna	!
alphabet	ábécé	!
alphabetical delimiter	alfabetikus határoló	!
alphabetical index	tárgymutató	!
already completed	már elkészült	!
alternate	alternatív	!
alternating	váltakozó	!
alternatively	ennek alternatívájaként	!
altitude	magasság	!
ambient light	háttérfény	!
amount	mennyiség, összeg (pénz)	!
and more!	és sok más(t)! (általános BS, ~stb.)	!
angle	szög	!
angled connector line	cikkcakkos összekötő vonal	!
annotation	magyarázat	!
announce	bejelenteni, bejelentés	!
anyway	mindenképp	!
aperture value	Apertúraérték	!
appearance	megjelenés	!
appendix	függelék, vakbél	!
appliance	készülék, eszköz?	!
apply	alkalmaz	!
appointment	értekezlet	!
approved	elfogadva	!
arcade	ügyességi (játék), játéktermi (pénzbedobós-gépes)	!
architecture	architektúra	!
archive	archívum	!
archive file	archívumfájl	!
arcsine	arkusz szinusz	!
arctangent	arkusz tangens	!
are you sure?	biztos benne?	!
area	terület	!
arrange	elrendezés	!
arrow	nyíl	!
arrowheads	nyílhegyek	!
artist	előadó (zene)	!
artwork	grafika	!
ascending	növekvő	!
aspect ratio	méretarány	!
assertion failure	érvényesítési hiba	!
assessment	felmérés	!
assign	hozzárendelés	!
assignment	hozzárendelés	!
assistant	segéd, asszisztens	!
attach	csatolás	!
attachment	melléklet (NEM: csatolmány)	!
audio	àrembi	!
audio feature	hangszolgáltatás	!
audio file	hangfájl	!
audiobook	Hangoskönyv	!
audit	auditálni	!
authorization	felhatalmazás, jogosultság	!
auto 	automatikus	!
autodetect	automatikus felismerés	!
autodiscovery	automatikus feltérképezés	!
automatic	automatikus	!
autopilot	tündér	!
autotext	szöveg-o-mata	!
available	elérhető	!
avatar	avatar	!
axial	tengelyirányú	!
b-spline	b-spline	!
backend	háttér (összetétel), háttérprogram	!
background color	háttérszín	!
background fill	háttérkitöltés	!
backport	visszaportolni	!
backspace	backspace	!
backup	Biztonsági mentés, tartalék (~pót dolog, nem másolat)	!
backup copies	biztonsági mentések	!
backup domain controller	Tartalék tartományvezérlő	!
backward	vissza	!
balance columns	oszlopok kiegyensúlyozása	!
ban	tiltani, kitiltani	!
banner	kísérőoldal (nyomtatás), reklámcsík (web)	!
bar	bigyó	!
base line	alapvonal	!
base64	base64 kódolás	!
based	-alapú (Java-alapú)	!
batch file	parancsfájl	!
battery	akkumulátor, nem telep, azt nem lehet tölteni	!
baudsebesség	átviteli sebesség	
bcc	rejtett másolat (e-mail)	!
behavior	viselkedés	!
belong	tartozni vhova	!
benchmark	teljesítményteszt	!
best viewed with	megtekintéshez javasolt:	!
bibliography	irodalomjegyzék	!
binary file	bináris fájl	!
binary operator	bináris operátor	!
bitmask	bitmaszk	!
bitrate	bitsebesség	!
black white	fekete-fehér	!
blacklist	feketelista	!
blank	törölni (CD-t), üres	!
bleed marks	Kifutójelek	?
blind copy	rejtett másolat	!
bloat	túlméretezett	!
block	blokk (FS), tiltás (IM)	!
block buffer	blokk puffer	!
block device	blokkeszköz	?
board game	táblajáték	!
body	törzs	!
bonding devices	nyalábolt eszközök	!
book	könyv	!
book excerpt	könyvkivonat	!
book mark	könyvjelző	!
bookmark	könyvjelző	!
boolean and	logikai És	!
boolean not	logikai nem	!
boolean or	logikai vagy	!
boolean value	logikai érték	!
boolean xor	logikai kizáró vagy	!
boot	indítani, rendszerindítás (folyamat)	!
boot loader	rendszerbetöltő (grub, lilo)	!
boot sector	boot szektor	!
bootstrap	rendszertöltő	?
bopomofo	bopomofo	!
border	szegély	!
bottleneck	szűk keresztmetszet	!
bounce key	billentyűszűrés	!
braces	kapcsos zárójelek	!
bracket	zárójel	!
bracket matching	Zárójelek párosítása	!
brackets	szögletes zárójelek	!
brand	márka	!
break	törés	!
breakpoint	töréspont	!
breve	breve	!
brightness	fényerő	!
brightness / contrast	fényerő / kontraszt	!
broadcast	üzenetszórás	
brochure	brosúra	!
broken	sérült	!
brownstone	homokkő	!
browse	Tallózás	!
browser	böngésző	!
brush	ecset	!
buddy	partner (IM)	!
bug	hiba, hibajelentés	!
built-in	beépített	!
bullets and numberings	felsorolás és számozás	!
button type	gombtípus	!
byte	bájt	!
calculate	számítás	!
calculation template group	számítássablon-csoport	!
call stack	hívási verem	!
callback	visszahívás	!
callout	felirat	!
camera	fényképezőgép	!
camera position	kamerapozíció	!
can not	nem lehet	!
can't	nem lehet	!
cancel	megszakítani, Mégse (gomb)	!
canceled by user	felhasználói megszakítás	!
canonicalize		
canvas	rajzvászon	!
capability	Képesség	!
capitals	nagybetűk	!
captcha	captcha	?
capture	rögzíteni	!
caret	kurzor	!
cartoon	rajzfilm	!
cartridge	kazetta	!
cascade windows	lépcsőzetes ablakelrendezés	!
case sensitive	Kis- és nagybetűs	!
catalog	katalógus	!
category	kategória	!
cc	másolat (e-mail)	!
cd-rom drive	cd-meghajtó	!
centered	középre helyezett (háttérkép)	!
centralize	központosítani	!
certificate	tanúsítvány	!
certificate authority	hitelesítésszolgáltató	!
certificate issuer	tanúsítvány kiállítója	!
change	módosítani, változtatni	!
changelog	változások listája, változáslista	!
channel subscription	feliratkozás csatornákra	!
chapter	fejezet	!
char cell	karaktercella	!
character	karakter	!
character device	karakteres eszköz	?
characteristics	jellemző	!
charcoal sketch	szénvázlat	!
chart	diagram	!
check	ellenőrizni, keresni (~ for: vmit, pl frissítést)	!
check box	jelölőnégyzet	!
check spelling	helyesírás-ellenőrzés	!
checkbox	jelölőnégyzet	!
checkered	kockás	!
checkered diagonal	rombuszos	!
checkout	átváltani, átváltás	!
checkpoint	ellenőrzőpont	!
cherry-pick	mazsolázni (git)	?
child	gyermek	!
child process	gyermekfolyamat	!
chipset	lapkakészlet	!
choose	válasszon	!
chroma	színesség 	!
chrominance	színesség 	!
cipher	titkosító	!
circle	kör	!
circle arc	körív	!
circle pie	kördiagram	!
circle pie, unfilled	kördiagram kitöltés nélkül	!
circle sector	körcikk	!
circle segment	körszelet	!
circumflex	circumflex	!
city	város	!
cjk compatibility	távol-keleti kompatibilitás	!
class id	osztályazonosíó	!
classic	klasszikus	!
client	Ügyfél, kliens	!
clipart	clipart	!
clipboard id	vágólap azonosítója	!
cloud computing	számítási felhő	?
cmyk	cmyk	!
coarse grained	durva felbontású	!
code	kód	!
code map	karakterkiosztás	!
code segment	kódszegmens	!
codec	kodek	!
collapse	Összecsukás	!
color	szín	!
color bars	színellenőrző csíkok	?
colorblind	színtévesztő	!
colorpicker	színválasztó	!
column	oszlop, hasáb	!
column spacing	hasábtávolság	!
combo box	legördülő menü, lenyíló menü	!
comma	vessző	!
commands	parancsok	!
comment	megjegyzés, hozzászólás (web)	!
commit	végrehajtani, véglegesíteni (vcs)	!
common	általános, közös, gyakori	!
common file	közös fájlok	!
common name	általános név (cert)	!
company	cég	!
compile	fordítás	!
complete	kész	!
completion	kiegészítés	!
compliant	megfelelő, -kompatibilis (utótag)	?
compose	összeállítani (e-mail)	!
compress	tömöríteni	!
compressed	tömörített	!
concordance file	szómutatófájl	!
conditional formatting	feltételes formázás	!
conditional style	feltételes stílus	!
conditional text	feltételes szöveg	!
cone	kúp	!
conference proceedings	konferencia-jegyzőkönyv	!
conference report	konferenciabeszámoló	!
confidence level	konfidenciaszint	!
confidential	titkos	!
confidentiality level	titkossági szint	!
config file	beállítófájl, konfigurációs fájl	!
configure	beállítás	!
confine	korlátozni	!
confirm	megerősítés	!
confirm delete	törlés megerősítése	!
confirm receipt	kézhezvétel megerősítése	!
connect	csatlakozni	!
connector	Összekötő	!
connector attributes	Összekötő attribútumai	!
connector reserved 2	2. fenntartott összekötő	!
consecutive numbering	folyamatos számozás	!
consolidate	Összesítés	!
contact	névjegy (címjegyzékben), partner (IM)	!
contain	tartalmaz	!
content negotiation	tartalomegyeztetés	?
context	környezet	!
context menu	helyi menü (jobbklikkes)	!
continuous	folytonos	!
contour	körvonal	!
contrast	kontraszt	!
contributor	közreműködő, hozzájáruló(?)	?
control	vezérlőelem	!
convened by	Összehívta:	!
conversation	társalgás	!
cookie	süti	!
cookies	sütik	!
coordinate	koordináta	!
coprocess	társfolyamat	?
correct	javítani, helyes	!
corrupt	sérült	!
cos	cos	!
could not	nem sikerült	!
couldn't	nem sikerült	!
country	ország	!
cover	borító	!
cpu	processzor	!
cr	cr	!
cr lf	cr lf	!
crash	összeomlás	!
crawl	bejárás (tartalomindexelő)	!
crc check	ellenőrzőösszeg	!
creation	létrehozás	!
creator	létrehozó	!
credential	hitelesítési adatok	!
credit	követelés	!
credits	köszönet	!
criteria	feltételek	!
crop	levágás, képkivágás	!
crop marks	vágójelek	?
crossplatform	keresztplatform	!
crypto	titkosítási-	!
cube	kocka	!
cubic spline	harmadfokú spline	!
curly bracket	kapcsos zárójel	!
currency	pénznem	!
current context	jelenlegi környezet	!
currently	pillanatnyilag	!
cursor type	kurzortípus	!
curve integral	vonalintegrál	!
custom	egyéni	!
custom dictionaries	saját szótár	!
custom window	egyéni ablak	!
customize	Személyre szabás	!
cycle	körforgás	!
cylinder	henger, cilinder (lemezen)	!
cyrillic	cirill	!
dash	vonás, dash (Ubuntuban)	!
data	adatok	!
database	adatbázis	!
databuffer size (mb)	adatpuffer mérete (mb)	!
date	dátum	!
day	nap	!
dde	dde	!
dde error	dde-hiba	!
dde field	dde-mező	!
dde link	dde-kapcsolat	!
deactivate	kikapcsolás	!
deblocking	blokkbontás	!
debugger	hibakereső	!
decimal	decimális	!
decimal accuracy	tizedes pontosság	!
decimal places	tizedeshelyek	!
decimal separator	tizedesjel	!
decoder	dekódoló	!
decompress	kibontani	!
decorative	díszes	!
decrease indent	behúzás csökkentése	!
decrease spacing	helykihagyás csökkentése	!
decrypt	visszafejt	!
decryption	visszafejtés, titkosítás feloldása	!
define	meghatározás	!
definition	meghatározás	!
degree	fok	!
degrees_freedom	szabadsági_fok	!
deinstall	eltávolítás	!
deinstallation	eltávolítás	!
deinterlace	váltottsorosság megszüntetése	!
delay	késleltetés	!
demote	lefokozás	!
denominator	nevező	!
denote	jelezni	!
deny	megtagadni, letiltani	!
department	részleg	!
depth	mélység	!
descending	csökkenő	!
description	leírás	!
deselect all	kijelölés megszüntetése	!
deserialize	visszafejtés	?
design	látványterv, tervezni	!
design view	terv nézet	!
desktop	asztal (képernyőterület), asztali környezet (GNOME), munkaállomás (hw)	!
desktop background	háttér	!
desktop environment	asztali környezet	!
detail	részlet	!
detected	felismerni (eszközt), csatlakoztatva (ipod detected)	!
detective	detektív	!
determine	meghatározni	!
development	fejlesztés	!
diacritic	mellékjel	!
diagnostic	diagnosztikai	!
dial-up	betárcsázós (modem)	!
dialing	tárcsázás	!
dialog	párbeszédablak, ablak (doksiban)	!
dictionary	szótár	!
digest	kivonat	!
digital	digitális	!
dimension line	méretvonal	!
dimensioning	méretezés	!
din a4 portrait	din a4 álló	!
din a5 landscape	din a5 fekvő	!
direct column break	közvetlen hasábtörés	!
direct cursor	közvetlen kurzor	!
direct line break	közvetlen sortörés	!
direct page break	közvetlen oldaltörés	!
directive	direktíva	?
directly	közvetlenül	!
directory	könyvtár, címtár	!
directory tree	könyvtárstruktúra	!
discard	elvetés	!
disconnected	szétkapcsolva	!
discover	feltérképezni (hw-t)	!
disk	lemez	!
dismiss	Rendben (üzenetre), bezárás (ablak), megszüntetés (kijelölés)	!
dispatcher	kézbesítő, kezelő	?
display	megjelenítés, kijelző	!
display manager	bejelentkezéskezelő	?ablakkezelő
dissertation	Értekezés	!
dissolve	Áttűnés	!
distance	távolság	!
distinct values	különböző értékek	!
distinguished name	megkülönböztető név (LDAP)	!
distort	torzítás	!
distribution	eloszlás, disztribúció (Linux ~), NEM: terjesztés	!
dithering	színközelítés	!
divide	osztás	!
dividend	osztandó	!
divisor	osztó	!
dns server	dns-kiszolgáló	!
dockapp	dokkalkalmazás	!
dot dash	pont vonás	!
dotted underline	pontozott aláhúzás	!
double	dupla	!
double click	dupla kattintás	!
double curve integral	kettős vonalintegrál	!
double integral	kettős integrál	!
double quotes	kettős idézőjelek	!
double-angled line	kettős cikkcakkos vonal	!
downgrade	visszafejlesztés (csomagkezelésnél)	!
drag	húzni (egérrel)	!
drag and drop	fogd és vidd	!
draw	rajzolás	!
draw functions	rajzolóműveletek 	!
draw object	rajzobjektum	!
draw object bar	rajzobjektum eszköztár	!
drawer	fiók	!
drawing	rajz	!
drive	meghajtó	!
driver	illesztőprogram (szoftverek), meghajtó (hardverek)	!
driver settings	illesztőprogram beállításai	!
drop caps	iniciálé	!
dropdown	legördülő	!
droplets	cseppek	!
dual-boot		?
dummy	üres	!
duration	időtartam	!
dwell click	elidőzési kattintás	!
e-mail address	e-mail cím	!
e.g.	például	!
easy	egyszerű, ellenjavallt: könnyű	!
editing time	szerkesztés ideje	!
edition	kiadás	!
editor	szerkesztő	!
effect	életbe lép (módosítás), hatás, effektus	?
elapsed	eltelt (idő)	!
element	elem	!
eliminate points	pontok eltávolítása	!
ellipse	ellipszis	!
ellipse pie	ellipszisdiagram	!
ellipse segment	ellipszisszelet	!
ellipsize	kihagyás (ki...ás)	!
elliptical arc	elliptikus ív	!
email	e-mail	!
embed	beágyazni	!
embedded	beágyazott	!
embedded object (ole)	beágyazott objektum (ole)	!
emblem	matrica	!
emoticon	hangulatjel	!
emphasis	kiemelés	!
empty	Üres	!
empty recycle bin	lomtár ürítése	!
emulation	emuláció	!
enabled	engedélyezve	!
enclosed alphanumerics	csatolt alfanumerikus karakterek	!
encode (pgp)	titkosítás (pgp)	!
encoder	kódoló	!
encounter	találni (váratlan értéket)	?
encrypt	titkosít	!
encryption	titkosítás	!
end quote	idézet vége	!
end value	végérték	!
endash	gondolatjel, –	!
endless	végtelen	!
endnote	végjegyzet	!
enforce	kikényszeríteni	!
engine	alrendszer	!
enhance edges	Élek kiemelése	!
enlargement	méret növelése	!
entry	bejegyzés	!
envelope	boríték	!
environment variable	környezeti változó	!
eps color format	eps-színformátum	!
eps version	eps-verzió	!
equal	egyenlő	!
equalizer	hangszínszabályzó	!
error margin	biztonsági ráhagyás	!
error message	hibaüzenet	!
error occurred	hiba történt	!
escape	levédés, fedés	!
essential	alapvető	!
establish	létrehozni	!
estimate	becsülni	!
evaluate	kiértékelni	!
evaluation	kiértékelés	!
even	páros, akkor is	!
example	példa, például: [lehetséges értékek]	!
exceed	túllépni, meghaladni	!
excel documents	excel-dokumentum	!
excel templates	excel-sablon	!
exception (-)	kivétel (-)	!
excess length	fölös hossz	!
exclusive access	kizárólagos hozzáférés	!
executable file	végrehajtható fájl	!
exist	létezik	!
existing	meglévő, létező	!
existing design	meglévő látványterv	!
expand	kinyitni (UI elemet), bővíteni (partíciót)	!
expected location	elvárt hely	!
expiration	lejárat (dátum)	!
expired	lejárt	!
explorer	aktakukac	!
exponential function	exponenciális függvény	!
exponential increasing	exponenciális növekedés	!
export file	fájl exportálása, exportálási fájl	!
exposure time	Expozíciós idő	!
expression	kifejezés	!
extended help	részletes súgó	!
extended selection on	kiterjeszthető kijelölés be	!
extended tips	részletes tippek	!
extent	kiterjedés	!
external	külső	!
extract	kibontani, beolvasni (cd-t, rip)	!
eyedropper	szemcseppentő	!
facilitate	megkönnyíteni	!
facility	szolgáltatás	!
factor	tényező	!
factorial	faktoriális	!
fade	elhalványulás	!
failed	nem sikerült (vmit csinálni), meghiúsult (vmi)	!
fallback	tartalék	!
false	hamis	!
favicon	weblapikon	!
favorites	kedvencek	!
fax cover	fax fedőlap 	!
feature	szolgáltatás, funkció, jellemző	!
featureful	funckiógazdag	!
feed	hírforrás	!
feedback	visszajelzés	!
fetch	letölteni, lekérni	!
field	mező	!
field codes	mezőkódok	!
field delimiter	mezőelválasztó	!
file browser	Fájlböngésző	!
file chooser	fájlválasztó	!
fill color	kitöltőszín	!
fill data series	adatsor kitöltése	!
filter	szűrő	!
financial	pénzügyi	!
find replace	keresés és csere	!
finish	befejezés	!
first name	utónév	!
fit to frame	keretbe illesztés	!
fixed	rögzített	!
flag	jelző	!
flash fired	Vakuvillanás	!
flashcard	tanulókártya	!
flavor	változat	!
flip horizontally	vízszintes tükrözés	!
flip vertically	függőleges tükrözés	!
floating frame	Úszó keret	!
flow charts	folyamatábrák	!
font color	betűszín	!
font effects	betűhatások	!
font size	betűméret	!
font weight	betűvastagság	!
font width	betűszélesség	!
fontwork		
foo	izé	!
footer	Élőláb	!
footnote	lábjegyzet	!
for later reference	későbbi használat céljából	!
for your information	tudnivaló	!
foreground	előtér	!
foreground color	előtérszín	!
foreground transparence	előtér átlátszósága	!
fork	indítani (programot), elágazás, továbbfejlesztés (projekt, kb)	!
form controls	Űrlapelemek	!
form design	Űrlaptervezés	!
form letter	körlevél	!
form letter field	körlevélmező	!
format	formázni, formátum	!
formatted	formázott	!
fraction bar	törtvonal	!
frame	Keret (web), képkocka (film)	!
framework 	keretrendszer	!
free positioning	kötetlen elhelyezés	!
free/busy	szabad/elfoglalt (naptár)	!
freecell	admirális	!
freeform line	szabadkézi vonal	!
freeform polygon	szabad formájú sokszög	!
freeze window	ablak rögzítése	!
frequency	gyakoriság	!
frequency scaling	órajelszabályozás	?
freshen	felfrissít (tömörített fájlt)	!
from	feladó (e-mail)	!
frontend	előtétprogram, felület	!
full background report for	Background Report 	
full featured	teljes felszereltségű (~általános BS)	!
full pathname	teljes elérési út	!
full screen	teljes képernyő	!
fully featured	teljes felszereltségű (~általános BS)	!
fully qualified domain name	teljes képzésű tartománynév	!
function	függvény (programozói), funkció (felhasználói szemmel)	!
gallery	képtár, galéria	!
gamma correction	gamma-korrekció	!
gamma value	gamma-érték	!
gap	hézag	!
gapless	szünetmentes (lejátszás)	!
gateway	átjáró	!
general	Általános	!
generate	előállítani	!
generic	Általános	!
genre	műfaj	!
get	get (FTP), megszerzés (ige)	!
getting started	kezdeti lépések, mielőtt elkezdi, ... használatának megkezdése	!
given angle	adott szög	!
global settings	Általános beállítások	!
glue point	csatolópont	!
glyph	szimbólum	!
go	Ugrás (gomb)	!
goal seek	célértékkeresés	!
grace time	türelmi idő (lemezkvóta)	!
grand total	végösszeg	!
grant	megadni	?
granular	részletes	?
graph	grafikon, gráf	!
graphic	kép	!
graphics	kép	!
graphics card	videokártya	!
gravel	kavicsok	!
grayscale	szürkeárnyalatos	!
greylist	szürkelista	!
greyscale	szürkeárnyalatos (NEM: szürkeskálás)	!
grid view	rácsnézet	!
group box	csoportpanel	!
group policy	csoportházirend	!
grow	növelni, nagyítani	!
guides	vezetővonal	!
half-sphere	félgömb	!
handle	kezelni, Leíró (programozásban), Fogantyú (GUI)	!
handout	emlékeztető	!
hanging indent	függő behúzás	!
hard link	hard link	?
hardening		
hatching	vonalkázás	!
header	fejléc, élőfej	!
heading	címsor	!
headless	kijelző nélküli	!
headphone	fejhallgató	!
heap	kupac (memória)	!
help about help	a súgó használata	!
helper	segédprogram	?
heredoc	here-dokumentum	?
hibernate	hibernálás	!
hidden	rejtett	!
hierarchy	hierarchia	!
highlight	kiemelés	!
horizontal	vízszintes	!
horizontal line	vízszintes vonal	!
horizontal pitch	vízszintes dőlés	!
hotplug	működés közben cserélhető	?
hover	rámutatni (egérrel)	!
html document	html-dokumentum	!
html source	html-forrás	!
http proxy	http-proxy	!
hue	színárnyalat	!
human readable	Emberek által olvasható (fájlméret), közérthető	!
hyperbolic cosine	koszinusz hiperbolikusz	!
hyperbolic cotangent	kotangens hiperbolikusz	!
hyperbolic sine	szinusz hiperbolikusz	!
hyperbolic tangent	tangens hiperbolikusz	!
hyperlink	hiperhivatkozás	!
hyphenate	elválasztás	!
hyphenation	elválasztás	!
hyphens	elválasztójel	!
i.e.	azaz	!
identification	azonosítás	!
ignore	mellőzés	!
illegal operation	zugműtét ;), érvénytelen művelet	!
illumination	megvilágítás	!
illustration	Ábra	!
illustration index	Ábrajegyzék	!
im	azonnali üzenet	!
image map	képtérkép	!
imap account	imap-fiók	!
imperial	angolszász (mértékrendszer)	!
implement	megvalósítani	!
implementation	Implementáció, megvalósítás	!
import file	fájl importálása, importálási fájl	!
in order to	[vmi] érdekében	!
inactive	inaktív	!
inadmissable path	nem engedélyezett útvonal	!
inbox	beérkezett üzenetek	!
inch	hüvelyk	!
include	felvenni	!
incoming	bejövő	!
incoming mail	bejövő levelek	!
incomplete	befejezetlen	!
incorrect	helytelen, hibás	!
increment	növekmény, növelés	!
index	index, jegyzék, tárgymutató	!
index and tables	jegyzékek	!
index mark	tárgymutatójel	!
indices	indexek	!
individual	önálló, egyes	?
individual words	különálló szavak	!
infinity	végtelen	!
information	Információk (tsz!)	!
inherited	Örökölt	!
initial	kiinduló, eredeti	!
initialization	előkészítés	!
initialize	előkészíteni	!
inline	beágyazott	!
inner join	belső összekapcsolás	!
input	bevitel	!
input field	beviteli mező	!
input method	beviteli mód	!
insert	beszúrás, behelyezés (CD-t)	!
inspect	megfigyelni	!
installation	telepítés (kész), telepítő (setup.exe)	!
instruction pointer	utasításmutató	!
integer	egész szám	!
integral	integrál	!
integration	integráció	!
intensity	intenzitás	!
interaction	beavatkozás (emberi), együttműködés (gépi)	!
interlaced	váltottsoros	!
internal	belső	!
internet	internet (kisbetű. mindig.)	!
interpolation	interpoláció	!
interval	időköz, tartomány	!
introduction	bemutatás, ismertetés	!
introspect	betekintés	?
invalid host		
invert	invertálás, megfordítás	!
invitation	meghívás	!
invite	meghív	!
iso speed rating	ISO-sebességminősítés	!
issue	kiállítani	!
italic	dőlt	!
item	elem	!
iterations	iterációk	!
jigsaw	kirakó, puzzle	!
job	Feladat	? az nem a task?
journal	napló, folyóirat	!
jukebox	zenegép	!
justified	sorkizárt	!
justify	sorkizárás	!
keep-alive	kapcsolatfenntartás	!
keepalive	kapcsolatfenntartás	!
kerning	alávágás	!
key	kulcs	!
key word	kulcsszó	!
keypad	számbillentyűzet	!
kick	kirúgni	!
kickban	kirúgás és kitiltás	!
lag	késleltetés	!
landscape	fekvő	!
laptop	noteszgép	!
large circumflex	nagy circumflex	!
last name	vezetéknév	!
last used	utoljára használt	!
latitude	Szélesség	!
laucher	indító	
launch icon	indítóikon	!
lavender	levendula	!
layer indicator	rétegjelző	!
layout	Elrendezés (UI), kiosztás (bill)	!
ldap server	ldap-kiszolgáló	!
lead-in	bevezető (szakasz CD-n)	!
leading	kezdő (karakter)	!
left join	bal oldali összekapcsolás	!
legacy	örökölt	!
legend	jelmagyarázat	!
letter	betű, levél, letter (lapméret)	!
letterlike symbols	betűszerű szimbólumok	!
level	szint	!
library	függvénytár, programkönyvtár, gyűjtemény (multimédia)	!
license	licenc	!
license agreement	Licencegyezmény/szerződés?	?
lightweight	könnyűsúlyú	?
limit	korlát, határ	!
line	Vonal, sor	!
line break	sortörés	!
line count	sorok száma	!
line head	vonalfej	!
linear	lineáris	!
linear ascending	egyenletesen növekvő	!
linear regression	lineáris regresszió	!
linear transfer	lineáris átvitel	!
linen	vászon	!
link	Hivatkozás (weben), Link (fájlrendszeren)	!
link frames	keretek összekapcsolása	!
list	felsorolni, lista	!
list box	listamező	!
literal mask	literálmaszk	!
load	betölteni, terhelés (hw)	!
locale	területi beállítások, területi beállítás	!
lockdown	zárolás	!
locked	zárolt	!
locking problem	erőforrás-zárolási hiba	!
log file	naplófájl	!
log in	bejelentkezni	!
log out	kijelentkezni	!
logarithm	logaritmus	!
logarithm regression	logaritmikus regresszió	!
logo	logó	!
longitude	Hosszúság	!
look and feel	megjelenés	!
look feel	megjelenés	!
loopback	visszacsatolás	!
lower	háttérbe küldeni/vinni? (ablakot)	?
lowercase	kisbetűk	!
luma	fényesség	!
luminance	fényesség	!
lyrics	dalszöveg	!
lzw encoding	lzw-tömörítés	!
mac graphic	mac-grafika	!
mac-picture	mac-kép	!
machine	gép	!
macro organizer	makrószervező	!
magazine	magazin	!
mail merge	körlevél	!
maildir	levélmappa	!
mailing list	levelezőlista	!
main entry	főbejegyzés	!
main grid	vezetőrács	!
main title	főcím	!
main toolbar	fő eszköztár 	!
maintainer	karbantartó	!
major axis	főtengely	!
major interval	főbeosztás	!
make sure	Győződjön meg róla, hogy	!
malform		
malformed	helytelenül formázott	!
malicious	rosszindulatú	
malware	rosszindulatú program	?
manage	kezelni	!
manager	kezelő, menedzser	!
mandatory	kötelező	!
manipulate	kezel	!
manipulation	kezelés	!
manually	saját kezűleg	!
manufacturer	gyártó	!
map	leképezni, térkép	!
margin	margó	!
mark	jel, jelölés	!
markup	jelölő (általános), jelölőkód (konkrét)	?
masquerading	maszkolás	!
master document	fődokumentum	!
master server	elsődleges kiszolgáló	
master view	minta nézet	!
match	illeszkedik (minta), megfelel (kapott-várt érték), találat (keresésnél)	?
match case	kis- és nagybetűk egyeztetése	!
matrix	mátrix	!
max	max	!
maximize	maximalizálás	!
maximum	maximum	!
mean	közép	!
mean value	középérték	!
measure unit	mértékegység	!
measurement unit	mértékegység	!
media	adathordozó	!
media type	adathordozó típusa	!
memory cache	memóriabeli gyorsítótár	!
menu item	menüpont	!
menubar	menüsor	!
merge	egyesítés	!
metering mode	Mérési mód	!
method	eljárás, metódus (program), módszer (általános)	!
metric	metrika (hálózatok), metrikus (mértékrendszer)	!
microphone	mikrofon	!
migration	költözés, áttelepítés, átállás	!
millisecond	ezredmásodperc	!
min	min	!
mini icons	mini ikonok	!
minor faults	kisebb hibák	!
minor grid	segédrács	!
minor interval	albeosztás	!
minor x grid	x tengely segédrácsa	!
mirror	tükör	!
misc	egyéb	!
miscellaneous	egyebek	!
miscellaneous options	egyéb beállítások	!
missing	hiányzik	!
mixer device	keverőeszköz	!
mnemonic	hívóbetű	?
mobile carrier	mobilszolgáltató	!
modal	kizárólagos	!
monitor	figyelni (rendszert), monitor	!
monochrome	fekete-fehér	!
monospace	rögzített szélességű	!
more	további (információ), több (gomb)	!
morphing	morfolás	!
movie	film	!
multi-function	többfunkciós, multifunkciós	?
multiline input	többsoros bevitel	!
multipart/alternative	multipart/alternative	!
multipart/digest	multipart/digest	!
multipart/form data	multipart/form data	!
multipart/mixed	multipart/mixed	!
multipart/parallel	multipart/parallel	!
multipart/related	multipart/related	!
multiplayer	többrésztvevős	!
multiple	többszörös, több	!
multiply	szorzás	!
multiselection	többszörös kijelölés	!
multisession	több szakaszos (CD)	!
multitouch	többérintéses?	
multitrack	többsávos	!
music player	zenelejátszó	!
mute	némítani	!
my documents	dokumentumok	!
n-th root	n-edik gyök	!
nabla	nabla	!
name	név	!
name html design	html-terv neve	!
namespace	névtér	!
naming conflict	névütközés	!
native sql	natív sql	!
natural logarithm	természetes alapú logaritmus	!
natural numbers set	természetes számok halmaza	!
natural spline	természetes spline	!
navigate	navigálás	!
navigation	navigálás	!
navigator	navigátor	!
necessary	szükséges	!
net	hálózat	!
net access	hálózati hozzáférés	!
networking	hálózatkezelés	!
new	Új	!
next	tovább (gomb), következő	!
no	nem	!
no icon	nincs ikon	!
node	csomópont	!
nominal interest	névleges kamat	!
non profit	nonprofit	!
non-breaking spaces	nem törhető szóköz	!
non-profit	nonprofit	!
non-recoverable	helyrehozhatatlan	!
noname	névtelen	!
none	nincs	!
nonexistent	nem létező	!
nonprinting characters	nem nyomtatható karakter	!
normal	normál	!
not available	nem érhető el	!
not enough memory	nincs elég memória	!
not found	nem található	!
not implemented	nincs megvalósítva	!
note	jegyzet	!
numbering	számozás	!
numbering / bullets	számozás / felsorolás	!
numerator	számláló	!
numeric field	számmező	!
object	objektum	!
oblique	rézsút	!
oblique italic	erősen dőlt	!
occasion	alkalom	!
occurrence	előfordulás	!
odd	páratlan	!
offline	kapcsolat nélkül	!
offline (transacted)	kapcsolat nélkül (tranzakció után)	!
offset	eltolás	!
ok	ok	!
old value	korábbi érték	!
older	régebbi	!
ole	ole	!
ole automation error	ole automatizációs hiba	!
ole object	ole-objektum	!
on-screen	képernyőn megjelenő (utasítások)	!
online	on-line	!
online layout	megjelenítés weblapként	!
opaque	Átlátszatlan	!
open as template	megnyitás sablonként	!
operations	művelet	!
operator	operátor	!
optimal	optimális	!
optimize	optimalizálás	!
optimized	optimalizált	!
option	lehetőség, beállítás, kapcsoló	!
option bar	beállítások eszköztár 	!
option button	beállítások gomb	!
option fields	rádiógombok	!
optional	nem kötelező, elhagyható, opcionális	!
optional hyphens	feltételes elválasztójel	!
optional line break	feltételes sortörés	!
options	beállítások	!
order	rendezni, sorrend	!
organization	szervezet	!
organize	szervez, rendszerez	!
organizer	szervező	!
original	eredeti	!
orphan control	Árvasorok kezelése	!
other settings	egyéb beállítások	!
outbox	postázandó levelek	!
outgoing	kimenő	!
outgoing mail	kimenő levelek	!
outline	körvonal	!
overall	összesen	?
overclocking	?túlhajtás	
overflow	túlcsordulás	!
overhead	túlterhelés, ráhagyás	!
overlap	Átfedés	!
overview	Áttekintés	!
packetizer	daraboló	!
page break	oldaltörés	!
page setup	oldalbeállítás	!
pair kerning	betűpár alávágása 	!
paired	párosított (Bluetooth)	!
palettes	paletták	!
pane	ablaktábla	!
paper	papír	!
paper feed	papíradagoló	!
paper jam	papírelakadás	!
paragraph	bekezdés	!
parameters	paraméter	!
parental control	szülői felügyelet	!
parser	feldolgozó	?
partial	részleges	!
participants	résztvevők	!
partition	particionálni, partíció	!
partition table	partíciós tábla	!
pass count	menetek száma	!
passcode	jelkód	
password protected	jelszóval védett	!
paste special	irányított beillesztés	!
patch	javítócsomag, folt	!
patch bay	dugasztábla 	!
pause	szünet	!
pdf file	pdf-fájl	!
peer	partner	!
peer-to-peer	egyenrangú	!
pending	függőben	!
pending deletion	törlésre vár	!
pendrive	pendrive	?
perform	végrehajtani	!
performance	teljesítmény	!
period	időszak	!
permanent	végleges	!
permanently	véglegesen	!
permission denied	Hozzáférés megtagadva	!
permit	engedélyezni, engedély	!
personal	személyes	!
perspective shadow	perspektivikus árnyék	!
pertain	vonatkozik	!
phone/cellphone/fax	telefon/mobil/fax	!
phonetic symbols	fonetikus szimbólumok	!
physical memory	fizikai memória	!
pica	pica	!
pick	kiválasztás	!
picker button	pipettagomb	!
picture placeholders	kép helye	!
pie	tortadiagram	!
pin	rögzíteni (UI elemet)	!
pipeline	adatcsatorna	!
pixbuf	kép	!
pixels	képpont	!
placeholder	helykitöltő	!
plain	egyszerű (szöveg)	!
plan	tarifa (mobiltelefon)	!
play in full	végigjátszás	!
playback	lejátszás (multimédiát)	!
playlist	lejátszólista	!
please	-	!
please wait	kis türelmet	!
plot	ábrázolás	!
plot area	ábrázolási terület	!
plug-in	bővítőmodul	!
plugin	bővítmény	!
pointer	mutató	!
pointing device	mutatóeszköz	!
polarization	polarizáció	!
policy	házirend	!
pool	tároló (erőforrásoké)	?
pop3 account	pop3-fiók	!
populate	feltölteni	!
popup menu	helyi menü	!
popup window	felugró ablak, felbukkanó ablak	!
port	port	!
portable	hordozható	!
position	pozíció, elhelyezkedés	!
position not protected	pozíció módosítható	!
position protected	pozíció nem módosíható	!
position x	x pozíció	!
possible values	lehetséges értékek	!
poster	poszter	!
poster colors	poszterszínek	!
posterize	poszterizálás	!
postpone	elhalasztani	!
postprocess	utófeldolgozás	!
power management	energiagazdálkodás, energiakezelés	?
powerful	hatékony	!
powerpoint documents	powerpoint-dokumentum	!
preceding	megelőző	!
precision	pontosság	!
preference tool	beállítóeszköz	!
preferred	alapértelmezett (alkalmazás), elsődleges (beállítás)	?
prefix	előtag	!
prefix symbol	előtagjel	!
preformatted text	előformázott szöveg 	!
preload	előtöltés, előbetöltés	?
prepare	előkészíteni	!
presence	jelenlét, állapot	!
present	jelen van	!
presentation	bemutató	!
preset	előre beállított	?
prevent	megakadályozni	!
preview	Előnézet	!
previous	előző	!
primary domain controller	Elsődleges tartományvezérlő (PDC)	!
primary key	elsődleges kulcs	!
primary y axis	elsődleges y tengely 	!
principal	elsődleges, résztvevő (kerberos)	!
principle	alapelv	!
print	Nyomtatás, kiírni (képernyőre)	!
print monitor	nyomtatás felügyelete	!
print preview	nyomtatási kép	!
private data	személyes adat 	!
privilege	jogosultság	!
proceed	folytatni, tovább[lépni]	!
process	feldolgozni, folyamat	!
processing	feldolgozás	!
product	termék	!
product information	termékinformáció	!
production	éles (átv.)	!
productivity	irodai (alkalmzás)	!
profile	profil	!
program	Program, műsor (média)	!
program module	programmodul	!
project	projekt	!
projection x	x irányú vetület	!
promote	előléptetés	!
prompt	parancssor, felszólít, kérdés	!
property	tulajdonság	!
proportional	arányos	!
proprietary	zárt, nem nyilvános, szabadalomvédett	!
protect cells	cellavédelem	!
protect document	dokumentumvédelem	!
protect sheet	munkalapvédelem	!
protected workbooks	védett munkafüzetek	!
provide	biztosítani	!
provider	szolgáltató	!
province	tartomány	!
proxy server	proxykiszolgáló	!
public holidays	munkaszüneti napok	!
publication	kiadvány	!
publish	közzétenni	!
publisher	kiadó	!
pull	lekérni (dvcs)	?
purpose	cél	!
push	megnyomni, elküldeni (dvcs)	?
push button	nyomógomb	!
puzzle	kirakó, fejtörő, logikai (játék)	!
pv	jelenérték	!
quirk	kerülő megoldás	!
quota	kvóta	!
quotation	idézet	!
quote	idézet	!
radial	sugárirányú	!
radio button	rádiógomb	!
radius	sugár	!
radix	számrendszer	!
raise	előtérbe hozni (ablakot)	!
rate	osztályzás, sebesség	!
raw queue		
re-enable	újraengedélyezni	!
read	olvasás	!
read only	csak olvasható, írásvédett	!
ready	kész	!
ready...	kész...	!
real numbers set	valós számok halmaza	!
real part	valós rész	!
real path	valós útvonal	!
real time strategy	valósidejű stratégia[i játék]	!
realm	tartomány	!
recalculate	Újraszámolás	!
recently	legutóbb, nemrég	!
recipient	címzett	!
recommend	ajánlani	!
reconnect	újracsatlakozás	!
record	felvenni, rekord (DB), felvétel (média)	!
recover	helyrehozni, helyreállítani	!
recursive	rekurzív	!
recycle bin	lomtár	!
red	vörös	!
redial	újrahívás	!
redirect	átirányítani	!
redraw	Újrarajzolás	!
refactoring	újraírás	?
refer	hivatkozni	!
reference	hivatkozás	!
refuse	visszautasítani	!
register	regisztrálás	!
register-true	soregyen	!
registration	regisztráció, regisztráció	!
registration marks	Passzerjelek	
registry	rendszerleíró adatbázis (Windows), nyilvántartás (általános)	!
regression curve	regressziós görbe	!
regular	szabályos, normál	!
regular file	normál fájl	?
rehearse timings	időzítés elpróbálása	!
reinstall	újratelepíteni	!
reject	visszautasítás	!
rejected	visszautasítva	!
relation	reláció	!
relay	továbbítani	!
relief	dombormű, kiemelés	?
reload	Újratöltés	!
relocate	áthelyezni	!
remaining time	fennmaradó idő	!
remarks	megjegyzések	!
remember password	jelszó tárolása	!
remind again later	figyelmeztetés később	!
reminder	emlékeztető	!
removable	cserélhető, eltávolítható (eszköz)	!
render	megjelenítés	!
renderer	megjelenítő	!
renew	megújítani	!
reorder	átrendezni, újrarendezni	!
reorganize	Átszervezés	!
repaginate	Újratördelés	!
repair installation	telepítés helyreállítása	!
replace all	mindet cseréli	!
replication consumer	replikációfogadó	?
reply	válasz	!
reply to	válaszcím (e-mail)	!
report	jelentés	!
represent	ábrázolni	!
request	kérés	!
required	szükséges	!
resend	Újraküldés	!
reserve	védeni, fenntartani, lefoglalni	!
reserved blocks	lefoglalt blokkok	!
reset	alapállapot	!
resolve	megoldani (ütközést; problémát), feloldani (címet)	?
resource	erőforrás	!
resource exhausted	az erőforrás kimerült	!
respectively	rendre	?
response	válasz	!
responsible	felelős	!
restore	visszaállítás	!
restricted	zárt, korlátozott	!
restrictions	korlátozások	!
result	eredmény, találat (keresésé)	!
result_vector	eredményvektor	!
retract	visszavonás	!
retrieve	letölteni (fájlt, levelet), lekérni (adatot)	!
return	Enter (billentyű)	!
reverse	fordított	!
reverse circumflex	hacsek	!
review	áttekinteni, értékelés	!
revoke	visszavonni	!
rewrap	újratördelés	!
rewrite	újraírni	!
rgb	rgb	!
rgb colors	rgb-színek	!
rhombus	rombusz	!
ringtone	csengőhang	!
rip	beolvasni (cd-t)	!
roaming profile	központi profil (smb)	!
role	szerep	!
role playing game	szerepjáték	!
root	root (felhasználó), rendszergazdai (jogosultság)	!
roster	partnerlista (IM)	!
round bracket	kerek zárójel	!
round robin	körbeforgó	!
rounded	lekerekített	!
rounded edges	lekerekített élek	!
router	router, útválasztó	!
row spacing	sorköz	!
rule	szabály	!
ruler	vonalzó	!
salvage	maradványérték	!
sample rate	mintavételezési gyakoriság	!
sans	talpatlan	!
saturation	színtelítettség	!
save all	Összes mentése	!
scaled	kifeszített (háttérkép)	!
scan	lapolvasás, beolvasás (adatot), keresés (eszközt), vizsgálat	!
scanner	szkenner	!
scenario	eset	!
scenario manager	esetkezelő	!
scenario name	eset neve	!
schedule	ütemezni, műsorújság (TV)	?
schema	séma	!
scope	hatáskör	!
scrape	lekérdezés (http://en.wikipedia.org/wiki/Tracker_scrape)	!
screen	képernyő	!
screencast	képernyővideó	?
screenshot	Képernyőkép	!
scripting	parancsfájlok	!
scrobble	továbbítani (last.fm-re)	?
scroll bar	görgetősáv	!
scroll wheel	[egér]görgő	!
search criteria	keresési feltételek	!
search direction	keresés iránya	!
search results	Találatok	!
search string	keresendő karakterlánc	!
search term	keresőkifejezés	!
search vector	keresővektor	!
seat	munkaállomás	!
secondary axis	másodlagos tengely	!
section	szakasz	!
sector	szektor	!
secure	biztonságos	!
seed	megosztani (torrenten), forrás (torrent)	!
seek	tekerés (hang/videó), pozicionálás (fájl)	?
segment	szakasz	!
select	Válasszon (ablakcím), Kijelölés, Kiválasztás	!
selection box	választómező	?
self extracting	önkibontó	!
self-signed certificate	önaláírt tanúsítvány (MS)	?
self-test	önellenőrzés	!
semiautomatic	félautomata	!
semicolon	pontosvessző	!
send to back	háttérbe küldés	!
sensor	érzékelő	!
sent messages	elküldött üzenetek	!
sequence	sorozat	!
sequencer	szekvenszer	!
serial	soros, sorozatszám	!
serialize	sorbafejtés, sorosítás	?
series	sorozat	!
serif	talpas	!
service	szolgáltatás	!
session	Munkafolyamat, munkamenet, szakasz (CD-n)	?
set as default	beállítás alapértelmezettként	!
set tab order	bejárási sorrend megadása	!
set-operations	halmazműveletek	!
setting	beállítás	!
setup	telepítés	!
setup server	telepítőkiszolgáló	!
shader	árnyékoló	!
shading	Árnyalás	!
shadow	Árnyék	!
shadowing	Árnyékolás	!
shape	alak	!
sharpen	Élesítés	!
sharpness	Élesség	!
shear angle	nyírás szöge	!
sheet	munkalap	!
shell	parancsértelmező	!
shift	eltolás	!
shortcut	parancsikon (windows), gyorsbillentyű (ctrl+*)	!
show	Megjelenítés (NEM: mutatás)	!
shrink	zsugorítani, csökkenteni	!
shuffle	keverés	!
shutdown	leállítás	!
shutter speed	Zársebesség	!
side pane	oldalsáv	!
sign up	feliratkozni (NEM: előfizetni)	!
signature	aláírás	!
significance	szignifikancia	!
significant	jelentős	!
simple	egyszerű	!
single	egyetlen, egyedi	!
single click	egyszeres kattintás	!
single line spacing	egyszeres sorköz	!
single player	egyrésztvevős	!
size	méret	!
slant	ferdítés	!
slave	szolga	!
slide	dia	!
slide show	diavetítés	!
slider	csúszka	!
slogan	jelmondat	!
slot ids	tárolóhely-azonosítók	!
slow key	lassú billentyűk	!
slow terminals	lassú terminálok	!
smiley	hangulatjel	!
smooth	sima	!
smooth transition	sima átmenet	!
smtp	SMTP	!
snap grid	illesztőrács	!
snap line/point	illesztővonal és -pont	!
snap to grid	rácshoz illesztés	!
snapshot	pillanatkép	!
software bug	szoftverhiba	!
solarization	fakítás	!
solid color	homogén szín	!
solid-state drive	SSD	!
solitaire	pasziánsz	!
sorry	Elnézést (NEM: sajnálom/juk, bocs, stb)	!
sound	hang	!
sound card	hangkártya	!
sound files	hangfájlok	!
space	hely (háttértáron), szóköz	!
space bar	szóköz	!
spacing	térköz	!
spawn	indítani (programot)	!
speaker	hangszóró	!
special character	különleges karakter	!
special functions	speciális funkciók	!
specific	sajátos, különleges, egyedi	!
specify	megadás, adja meg	!
speech	beszéd	!
speed	sebesség	!
spellcheck	helyesírás-ellenőrzés	!
sphere	gömb	!
spin button	léptetőgomb	!
splash	indítókép	!
split	felosztás	!
split cells	cellák felosztása	!
spool	várólista (nyomtató, levelező)	!
spreadsheet	munkafüzet	!
sql mode	sql-mód	!
square bracket	szögletes zárójel	!
squiggle	cikkcakkos	!
stack trace	veremkiíratás, veremkövetési lista, veremkivonat	?
stagger even	páratlan címke eltolása	!
stagger odd	páros címke eltolása 	!
stale	elavult	!
standalone	önálló	!
standard	standard	!
standard deviation	szórás	!
standard filter	standard szűrő	!
standard input	szabványos bemenet	!
standard installation	szokásos telepítés	!
standard output	szabványos kimenet	!
start	kezdeni (tevékenységet), indítás (programot)	!
start value	kezdőérték	!
starter	próbamóka	!
startup	Indítás	!
stash	félretenni, félretett változat (git)	?
stat	statisztika, elérni (stat(1) hívása)	!
state	állapot, állam	!
stateful	állapottartó	!
statement	utasítás, állítás, nyilatkozat (jogi)	!
status bar	Állapotsor	!
statusbar	állapotsor	!
stderr	szabványos hibakimenet	!
stdin	szabványos bemenet	!
stdout	szabványos kimenet	!
stick	tapadás, mindig látható (ablak)	?
sticky keys	ragadós billentyűk	!
sticky notes	ragadós cetlik	!
stock chart	Árfolyamdiagram	!
stop	leállítás	!
storage options	tárolási lehetőségek	!
straight connector	egyenes összekötő	!
straight line	egyenes vonal	!
stream	szórni? (műsort), adatfolyam, műsor (multimédia)	?
stretch	nyújtás	!
stretched	nyújtott (háttérkép)	!
strict format	kötött formátum	!
strike-out	áthúzott	!
strings	karakterláncok	!
stroke	vonás (ecset, toll)	!
stub	csonk	!
stylesheet	stíluslap	!
stylist	stílussegéd	!
sub-	rész- (és nem: al-)	!
subdivision	albeosztás	!
subpixel	Képponton belüli	!
subscribe	feliratkozni (Nem: előfizetni)	!
subscription	feliratkozás	!
subset	részhalmaz	!
substitution	helyettesítés	!
subtotals	részösszeg	!
subtract	kivonás	!
subwoofer	mélysugárzó	!
suggestions	javaslatok	!
suite	alkalmazáscsomag	
sum	Összeg	!
summary	Összegzés	!
summary slide	Összefoglaló dia	!
superscript	felső index	!
superset	tartalmazó halmaz	!
suppress	elnyomni	?
swap	Lapozás, swap (partíció)	?
swipe	pöccintés	!
swiping from right edge	csúsztassa ujját a jobb élről	
sync	szinkronizálás	!
syndicate	tartalom megosztása	!
synonym	szinonima	!
synopsis	áttekintés, használat (kapcsolólista előtt)	!
syntax	szintaxis	!
system administrator	rendszergazda	!
system settings	rendszerbeállítások	!
tab	tabulátor (billentyű), fül (mindig látszik), lap (fülre kattintva látszik)	!
tab order	bejárási sorrend	!
tab stop	tabulátor	!
tab stop position	tabulátorpozíció	!
table	táblázat, tábla (DB)	!
table of contents	tartalomjegyzék	!
tabloid	tabloid	!
tabulator	tabulátor	!
tag	címke	!
take advantage	kihasznál (vmit)	!
tapping	koppintás	!
tar archive	tar-archívum	!
tarball	kátránygolyó ;)	!
target	cél	!
target file	célfájl	!
task	feladat	!
technology	technológia, technika	!
temp file	átmeneti fájl	!
temporary	Átmeneti	!
temporary buffer	átmeneti puffer	!
term	Kifejezés, feltétel (licenc)	!
terms of use	felhasználási feltételek	
text area	szövegterület	!
text body	szövegtörzs	!
text box	szövegdoboz	!
text flow	szövegfolyam	!
text wrap	szöveg törése	!
textual name	szöveges név	!
texture	mintázat	!
thesaurus	szókincstár	!
thesis	szakdolgozat	!
thick	vastag	!
thickness	vastagság	!
thin	vékony	!
third party	harmadik féltől származó	!
thousands separator	ezreselválasztó	!
thread	szál	!
threaded	szálakra bontott	!
threshold value	küszöbérték	!
thumbnail	Bélyegkép, Előnézet (pl. betűtípus)	!
tick mark	pipa	!
ticker	futószöveg 	!
tilde	tilde	!
tile fill	mozaikszerű kitöltés	!
tiled	mozaik (háttérkép)	!
timed out	túllépte az időkorlátot (művelet, program)	!
timeout	Időtúllépés (esemény), időkorlát (30 mp)	!
timestamp	időbélyeg	!
tip	tipp	!
title/position	beosztás	!
to mux	egyesíteni	!
todo	teendő	
toggle	átváltás	!
token	jelsor, token	!
tolerance	tolerancia	!
toner low	kevés a festék	!
tool menu	eszközmenü	!
toolkit	eszközkészlet	!
tools	eszközök	!
topic	téma	!
torus	tórusz	!
total	Összeg	!
touchpad	érintőtábla	!
touchscreen	érintőképernyő	!
trace	nyomkövetés	!
track	szám (zenei), sáv	!
traffic	forgalom	!
trailing	záró (karakter)	!
transaction	tranzakció	!
transcode	átkódolni (multimédiát)	!
transcript	átirat	!
transition	Átmenet	!
translation	fordítás	!
transmission channel	átviteli csatorna	!
transparency	Átlátszóság	!
transparency color	Átlátszó szín	!
transpose	felcserélés	!
traversal	bejárás	!
trigger	trigger (DB), eseményindító (DB), aktiváló	!
tristate	háromállapotú	!
troubleshooting	hibaelhárítás	!
true	igaz	!
truncate	csonkítani	!
trust	megbízhatóság	!
trusted	megbízható	!
try again	próbálja újra	!
tubes	csövek	!
tune	hangolni (alkalmazást)	!
tutorial	ismertető	!
tweak	finomhangolni	!
typed	típusos	!
ui	felület	!
umount	leválasztás	!
unallocated	lefoglalatlan	!
unbind	?	
uncategorized	kategorizálatlan	!
unchanged	változatlan	!
uncheck	törölje (jelölőnégyzetet)	!
uncompress	kibontani	!
unconfigured	beállítatlan	!
uncover	felfedés	!
under the hood	a felszín alatt	!
underflow	alulcsordulás	!
underline	aláhúzás	!
unexpected error	váratlan hiba	!
unformatted	formázatlan	!
ungroup	csoport szétbontása	!
unique	egyedi	!
unknown	ismeretlen	!
unlink	szétbontás, törlés (unlink())	!
unlock	feloldás	!
unmount	leválasztás	!
unmute	visszahangosítás	!
unnamed	névtelen	!
unpack	kibontani	!
unprotect	védelem feloldása	!
unpublished	kiadatlan	!
unread	olvasatlan	!
unrecognized	azonosítatlan	!
unrecoverable	helyreállíthatatlan	!
unrestricted	korlátlan	!
unspecif	nincs megadva	!
unsupported	nem támogatott	!
unsure	bizonytalan	!
untitled	cím nélkül	!
unzip	kibontani (archívumot)	!
upcoming	következő	!
upload	feltölteni	!
user agent	Felhasználói ügynök	?
user directory	felhasználói könyvtár	!
user's guide	felhasználói kézikönyv	!
usermode		?
utility	segédprogram	!
valid	érvényes	!
validation	ellenőrizni, jóváhagyás, javaslat	!
validity	Érvényesség	!
variance	szórásnégyzet	!
vectorized image	vektorizált kép	!
venue	helyszín	!
verbose	részletes	!
version control system	verziókezelő rendszer	!
video	Video- (előtag), videó (önállóan)	!
video file	videofájl	!
viewer	megjelenítő (nem: nézegető)	!
violation	-sértés	?
virtual desktop	Virtuális asztal	!
virtualization	virtualizáció	!
visibility	láthatóság	!
visible	látható	!
visit	felkeresni (weboldalt)	!
voice	hang	!
voicemail	hangposta	!
volume	hangerő, kötet	!
vulnerability	sebezhetőség	!
vulnerable	sebezhető	!
wakeup	ébredés	!
watch	figyelés	!
watermark	vízjel	!
web	web	!
web application	webalkalmazás, webes alkalmazás	!
web search	webkeresés	!
web service	webszolgáltatás	!
web site	webhely (ált.), weboldal (konkrét www)	!
web view	webnézet	!
welcome	üdvözöljük	!
while trying	... tett kísérlet során	!
whitelist	fehérlista	!
whitespace	üres hely (karakter)	?
widow control	fattyúsorok kezelése	!
wildcard	helyettesítő karakter	!
wireless	vezeték nélküli	!
workaround	kerülő megoldás	!
workflow	munkafolyamat	!
working directory	munkakönyvtár	!
workspace	munkaterület	!
wrap	sortörés, körbefuttatás (objektum körül) 	!
wrap contour on	körvonal megjelenítése	!
wrap off	körbefuttatás ki	!
wrap optimal	optimális körbefuttatás	!
wrap through	keresztülfuttatás	!
wrap transparent	Átlátszó körbefuttatás	!
wrapper	átalakító	!
wrong	hibás	!
y main grid	y tengely fő vezetőrács	!
y minor grid	y tengely segédrács	!
zero	nulla	!
zip code	irányítószám	!
zoom in	nagyítás	!
zoom out	kicsinyítés	!
